..........t.......................
..........t...F...................
..........t.P.TU..~....~.....?....
..........BBBBt......F..F...B.F...
......F..F....t......T..T..B..T...
......T..T....tBBBB..t..tTT...B...
......t..t.E..t......BBBBtt...t...
.....?B..BBBB?B..........BB...t...
..M...........................t...
..BBBBT..TBBBBBB..F~F...BBBBBBt...