..........t.......................
..........t...F...................
..........t.P.T...~....~.....B....
..........BBBBt......F..F...B.F...
......F..F....t......T..T..B..T...
......T..T....t......t..tTT...B...
......t..t.E..tBBBBBBBBBBtt...t...
.....BB..BBBBBB..........BB...t...
..M...........................t...
..BBBBT..TBBBBB...F~F...BBBBBBt...