........................
........................
........................
........................
........................
........................
........................
........................
P................G.....B
BBBBBBBBBBBBBBBBBBBBBBBB
