.................B
.................B
P................B
B........S....V..B
BBBBBBBBBBBBBBBBBB