........................
........................
........................
B......................B
B......................B
B......................B
B......................B
B......................B
B.P......U.......G.....B
BBTBBBBBBBBBBBBBBBBBBBBB
