........................t.....t........
........................t.....t........
........................t..?..t.....F..
...C....................t.....t..E..T..
.............F..........t.....tBBBBBB..
.......~.....T..........B..~..B........
............Bt........................B
.............t.............F........B.t
..P...M...B..t.M......M....T.....B..t.t
BBBBBBBBBB...tBBBBBFFFBBBBBBBBBBBB..t.t