........................
........................
........................
........................
........................
............t...........
............t...........
............t...........
P...........t....G.....B
BBBBBBBBBBBBBBBBBBBBBBBB
