........................
........................
........................
B......................B
B......................B
B......................B
B......................B
B......................B
B.P..............G.....B
BBTBBBBBBBBBBBBBBBBBBBBB
