......................
.........B............
..P..F.....?..........
..B..T.........B...?..
.....B...B............
.....t................
.C...t.....B.....B....
........B..t..........
.B.........t...BB~~E~~
.....B.....B.....BBBBB