......C...t.......................
..........t...F...................
..........t.P.T...~....~.....B....
..........BBBBt......F..F...B.F...
......F..F....t......T..T..?..T...
......T..T....tBBBB..t..tTT...B...
.....BB..t..E.t......BBBBtt...t...
.....B.~.B?BBBB..........BB...t...
..M.....................G.....t...
..BBBBT..TBBBBBB..F~F...BBBBBBt...