....................
....................
....................
....................
....................
....................
B...B...............
..B~...F............
.B.P.M.B........E...
BBBBBBBBBBBBBBBBBBBB