....................
....................
....................
....................
....................
....................
B...B.....F.........
..B~......T.........
.B.P.M.B..t.....E...
BBBBBBBBBBtBBBBBBBBB