....................
....................
.....B..~.....B.....
....................
....................
....................
..0..............F..
.............B...T..
.....P...........I..
BBBBBBBBBBBBBBBBBBBB