....................
....................
....................
....................
....................
....................
B...B...............
..B~................
.B.P................
BBBBBBBBBBBBBBBBBBBB
