....................
B...B...............
M.B~................
.B.P................
BBBBBBBBBBBBBBBBBBBB