....................
....................
....................
....................
....................
....................
B...B...............
..B~................
.B.P..........M.....
BBBBBBBBBBBBBBBBBBBB