.......................................E....................
B...B............BBBBB......................................
..B............................................BBBB.........
.B.P.....................................E..................
BBBBBBBBBBBBBBBBBBBBBBBBBBBBBBBBBBBBBBBBBBBBBBBBBBBBBBBBBBBB