t..............t
t..............t
t..............t
B...G........V.B
B.~.?~....~?BBBB
t..............t
t..............t
tB............Bt
BtP........SF.tB
BtTBBBBBBBBBTBtB