....................
.............F......
...........B.T......
.............t......
.P...CCC..B..t..MEM.
BB..~...~...~BBBBBBB