........B...........
....................
............B...G...
.E..............B...
....................
...............B....
...????..P..B.......
.........B..........
...BBBBB............