....................
....................
....................
....................
....................
....................
....................
....................
...P................
BBBB~...~...~BBBBBBB