.......................
.............F.........
...........B.T.........
.............t........B
...P......B..t..M.M.U.B
BBBB~...~...~BBBBBBBBBB