...........................
.............F.............
...........B.T............B
.............t........B...B
...P......B..t..M.M.U.B.E.B
BBBB~...~...~BBBBBBBBBBBBBB