....................
.............F......
...........B.T......
.............t......
...P......B..t..MEM.
BBBB~...~...~BBBBBBB