....................
....................
....................
....................
....................
....................
....................
....................
...P.............E..
BBBB~...~...~BBBBBBB