...........................BBBBB....
.......?........C..........t...t...~
......................B....t...tP...
....................F.....?B.C.BB...
.......F.......~....T...............
...~...T............t.............FB
.......B..T..F...B..t....B....~..FT.
....F..B..B..T...t..B....BB......TBB
..E.T.....B..B...t...............Bt.
BBBBB........B...t..B.............t.