..................
..................
P.................
B........S....V..B
BBBBBBBBBBBBBBBBBB