t..............t
t..............t
t..............t
B............V.B
B.~.?~....~?BBBB
t..............t
t..............t
tB............Bt
BtP........SF.tB
BtTBBBBBBBBBTBtB